0000,0000,0000,0000,0000,0000,0000,0000,0000,0000,0000,0000,0000
0000,0000,0000,0000,0000,0000,0000,0000,0000,0000,0000,0000,0000
0000,0000,0000,0000,0000,0000,0000,0000,0000,0000,0000,0000,0000
0000,0000,0000,0000,0000,0000,0000,0000,0000,0000,0000,0000,0000
1202,1212,1202,1202,1202,1202,1222,1202,1202,1202,1202,1202,1202
1202,1202,1202,1232,1202,1202,1202,1222,1202,1202,1252,1202,1202
0000,0000,0000,0000,0000,0000,0000,0000,0000,0000,0000,0000,0000
0901,0901,3009,0000,3009,0901,0901,0901,3009,0000,3009,0901,0901
0901,0901,3009,0000,3009,0901,0901,0971,3009,0000,3009,0901,0901
0901,0951,3009,0000,3009,0901,0901,0901,3009,0000,3009,0901,0901
0901,0901,3009,0000,3009,0901,0901,0901,3009,0000,3009,0901,0901
0000,0000,0000,0000,0000,0000,0000,0000,0000,0000,0000,0000,0000
0541,0541,0541,0541,0541,0541,0541,0541,0541,0541,0541,0541,0541
0501,0531,0551,0551,0551,0551,0551,0531,0531,0531,0501,0531,0501
0000,0000,0000,0000,0000,0000,0000,0000,0000,0000,0000,0000,0000
0000,0000,0000,0000,0000,0000,0000,0000,0000,0000,0000,0000,0000
0000,0000,0000,0000,0000,0000,0000,0000,0000,0000,0000,0000,0000
0000,0000,0000,0000,0000,0000,0000,0000,0000,0000,0000,0000,0000
0000,0000,0000,0000,0000,0000,0000,0000,0000,0000,0000,0000,0000
0000,0000,0000,0000,0000,0000,0000,0000,0000,0000,0000,0000,0000
0000,0000,0000,0000,0000,0000,0000,0000,0000,0000,0000,0000,0000
0000,0000,0000,0000,0000,0000,0000,0000,0000,0000,0000,0000,0000
0000,0000,0000,0000,0000,0000,0000,0000,0000,0000,0000,0000,0000
0000,0000,0000,0000,0000,0000,0000,0000,0000,0000,0000,0000,0000
0000,0000,0000,0000,0000,0000,0000,0000,0000,0000,0000,0000,0000
0000,0000,0000,0000,0000,0000,0000,0000,0000,0000,0000,0000,0000
0000,0000,0000,0000,0000,0000,0000,0000,0000,0000,0000,0000,0000
0000,0000,0000,0000,0000,0000,0000,0000,0000,0000,0000,0000,0000
0000,0000,0000,0000,0000,0000,0000,0000,0000,0000,0000,0000,0000
0000,0000,0000,0000,0000,0000,0000,0000,0000,0000,0000,0000,0000
0000,0000,0000,0000,0000,0000,0000,0000,0000,0000,0000,0000,0000
0000,0000,0000,0000,0000,0000,0000,0000,0000,0000,0000,0000,0000
0000,0000,0000,0000,0000,0000,0000,0000,0000,0000,0000,0000,0000
0000,0000,0000,0000,0000,0000,0000,0000,0000,0000,0000,0000,0000
0000,0000,0000,0000,0000,0000,0000,0000,0000,0000,0000,0000,0000
0000,0000,0000,0000,0000,0000,0000,0000,0000,0000,0000,0000,0000
0000,0000,0000,0000,0000,0000,0000,0000,0000,0000,0000,0000,0000
0000,0000,0000,0000,0000,0000,0000,0000,0000,0000,0000,0000,0000
0000,0000,0000,0000,0000,0000,0000,0000,0000,0000,0000,0000,0000
0000,0000,0000,0000,0000,0000,0000,0000,0000,0000,0000,0000,0000